1,1,1,1,1,1,1,1,1,1,1,1,1,1,1,1,1,1,1
1,0,0,0,0,0,0,0,0,0,0,0,0,0,0,0,0,0,1
1,0,0,0,1,1,0,10,0,0,0,0,0,0,11,0,0,0,1
1,0,9,0,0,1,0,0,0,1,1,1,1,0,0,0,0,12,1
1,0,0,0,0,1,0,15,0,0,0,0,1,0,0,1,1,0,1
1,0,0,0,1,1,0,0,0,0,0,0,1,0,0,1,0,0,1
1,0,0,0,0,0,0,0,0,0,14,0,0,0,0,0,0,13,1
1,0,0,0,0,0,0,0,0,0,0,0,0,0,0,0,0,0,1
1,1,1,1,1,1,1,1,1,1,1,1,1,1,1,1,1,1,1
