1,1,1,1,1,1,1,1,1,1,1,1,1,1,1,1,1,1,1
1,0,0,0,0,0,0,0,0,0,0,0,0,0,0,0,0,0,1
1,0,10,0,0,0,0,0,0,0,0,22,0,0,0,0,21,0,1
1,0,0,0,0,1,0,0,1,1,1,0,0,1,0,0,0,0,1
1,0,0,0,0,1,0,0,1,9,1,0,23,1,0,0,0,0,1
1,0,0,0,0,1,0,0,1,0,1,0,0,1,0,0,20,0,1
1,0,11,0,0,0,0,0,1,0,1,0,0,0,0,0,0,0,1
1,0,0,0,0,12,0,0,0,0,0,0,0,0,0,0,0,0,1
1,1,1,1,1,1,1,1,1,1,1,1,1,1,1,1,1,1,1
