1,1,1,1,1,1,1,1,1,1,1,1,1,1,1,1,1,1,1
1,0,0,0,0,10,1,0,20,0,0,0,1,0,0,0,0,0,1
1,0,0,0,0,0,1,0,0,0,0,0,0,0,0,42,0,0,1
1,0,0,0,0,0,0,0,0,21,0,0,1,0,0,0,0,0,1
1,9,0,0,0,11,1,0,0,0,0,0,1,0,0,40,0,0,1
1,0,0,0,0,0,0,0,0,31,0,0,1,0,0,0,0,0,1
1,0,0,0,0,0,1,0,0,0,0,0,0,0,0,41,0,0,1
1,0,0,0,0,0,1,0,0,30,0,0,1,0,0,0,0,0,1
1,1,1,1,1,1,1,1,1,1,1,1,1,1,1,1,1,1,1
